Norsk
special chars: æ, å, ø, é
å - alt-e (ku eshte d)
ø - alt-x (ku eshte b)
æ - alt-f (ku eshte y)
é - ast-i (ku eshte g)

ë - alt-v
ç - alt-u
ä - alt-h

echo 'const pairs = [' > ~/public_html/wl.js ; awk "/#/,/##/" ~/norsk.txt | grep "\-\-" | sed 's/^\([^\-\-]*\)\-\-\([^:]*\).*/{ key:"\1", value:"\2"},/g; s/   *//g; s/ the //g; s/ to //g' >> ~/public_html/wl.js ; echo '];' >> ~/public_html/wl.js

#
hei             -- hi
hallo           -- hello
velkommen       -- welcome : hallo og velkommen -- hello and welcome
takk            -- thanks : tusen takk   -- thank you very much
at              -- that, which : jeg vet at du vet
å               -- to
om              -- about, in, if : jeg kommer om ti minutter, om morgenen -- in the mornings, om sommeren -- in the summer
omtrent         -- around : toget kommer om omtrent fem minutter
den/det         -- that : den døren, det huset , den tredje mann -- the third man, den er min -- it is mine
denne/dette     -- this : dette huset, denne mannen
disse           -- these : disse mennene
de              -- those : de barna
har             -- to have : å ha : ha det -- bye : ha det bra -- goodbye, ha det gøy -- have fun!
hadde           -- had
takk for sist   -- good to see you again
går             -- to go, walk: iki, shkoj : å gå : jeg går -- une po iki , det er langt å gå -- its far to walk (easy search gar)
gått            -- gone : (past tense går) : det har gått bra -- its gone well
drå             -- go
dro             -- went, left
gikk            -- went
da              -- then
da              -- when : hadde du bil da du var ung -- did you have a car when you were young
beklager        -- sorry : beklager det -- appolagise for that
unnskyld        -- excuse me, sorry
en unnskyldning/unnskyldningen  -- the excuse, apology
veldig          -- very : veldig skitten -- very dirty
mye             -- much, a lot
mange           -- many, a lot : mange venner
flere           -- several
hvor            -- where, how : hvor er du -- where are you
hva             -- what : wha har du -- what do you have
hva enn         -- whatever, that which
hvilke/hvilket/hvilken  -- which
hvem            -- who : hvem har vann -- who has water
hvem sin/hvem sitt/hvem sine -- whose : e kujt: hvem sin barn er han -- whoose child is he?
hvem som        -- who : vet du hvem som ... -- do you know who..
hvor mye        -- how much
hvor mange      -- how many
hvor gammel     -- how old
hvordan         -- how
hvorfor         -- why
hver/hvert      -- every, each : hver dag -- every day
hvis            -- if
når             -- when : (easy search: nar)
koster          -- to cost
kostet          -- cost : did cost, har kostet : hvor mye kostet det -- how much did it cost
heter           -- are called : quhesh : hva heter du -- what are you called (what's your name)
het             -- was called
her             -- here
hitt            -- here
der             -- there : (der er det -- there it is)
mer             -- more
med             -- with : reiste med buss -- travelled by bus, med meg, med deg, med ham/med henne, med oss, med dere, med dem
men             -- but
ikke            -- not : hører ikke -- do not hear
også            -- also
morsom/morsomme -- funny : (-e pl)
gøy             -- fun : (easy search goy)
bare            -- only
bare hyggelig   -- youre welcome : (lit. only pleasure)
hyggelig        -- pleasant, pleasure, nice : hyggelig å møte deg -- nice te meet you
vær så snill    -- please : (lit. be so nice) : (easy search -- var sa snill)
vær så god      -- here you go: (na, merre) : (easy search -- var sa god)
vær             -- to be
var             -- was
kanskje         -- maybe
en helg/helgen  -- the weekend : god helg, i helgen -- on the weekend
god/godt/gode   -- good : et godt hus -- a good house, er det godt -- is it good
bedre           -- better : mye bedre -- much better
best            -- best : beste pappa -- the best dad
enn             -- than : mindre enn -- less than
en ost/osten    -- the cheese
en fisk/fisken/fisker/fiskene -- the fish
en mat/maten    -- the food
lager/å lage    -- to make
lager mat       -- to make food, cook
laget           -- made
et lag/laget    -- the team
en gitar/gitaren/gitarer/gitarene -- the guitar
spiller/å spille -- to play : spiller gitar, spill for meg -- play for me
spilte          -- played
et spill/spillet -- the game : hvem vinner spillet -- who is winning the game
hører/å hore    -- to hear, listen : hører på musik (easy search horer)
høres           -- sounds : (høres bra ut  -- sounds good)
hørt            -- heard : har hørt
hørte           -- heard : did hear
lytter/å lytte  -- to listen : lytter du -- are you listening? lytter til musikk -- listen to music
en lyd/lyden/lyder/lydene -- sound
en regning/regningen/regninger/regningene -- the bill, account
en servitør/servitøren/servitører/servitørene -- the waiter : servitøren har regningen -- the waiter has the bill
ser/å se        -- to see : jeg ser etter -- i'm looking for
ser ut          -- looks, dukem : hun ser trist ut -- she looks sad
ser frem        -- look forwards
så              -- saw : did see : så du det -- did you see that?
så frem         -- was looking forwards
sett            -- seen : har sett -- have seen, jeg har sett lyset -- i have seen the light
en lege/legen/leger/legene -- the doctor : er det noen leger her -- are there any doctors here?
en tannlege/tannlegen/tannleger/tannlegene -- the dentist
et marked/markedet -- the market
en professor/professoren -- the professor
syk/sykt        -- sick : (also really/very) det var sykt gøy -- it was really fun!
sjukt           -- sickness
en sykepleier/sykepleieren -- the nurse
et sykehus/sykehuset -- the hospital
en pille/pillen -- the pill
snill/snillt/snille -- kind, nice : en snilt hus : er du snill -- if you please
snillere        -- kinder
snillest        -- the kindest
smart           -- smart
stressende      -- stressful
stress          -- the stress : det er mye stress -- that is a lot of stress
stress          -- to stress
stresset        -- stressed
vanskelig/vanskelige -- difficult: (-e pl)
lett            -- easy, light : Norsk er lett å lære -- norwegian is easy to learn , denne er ganske lett -- this is fairly light
lettere         -- easier
interessant     -- interesting
en jobb/jobben  -- the job
jobber/å jobbe  -- to work : jobber med -- working on
jobbet          -- worked
varm/varmt      -- warm
varmere         -- warmer, hotter
kalt            -- cold
høy/høyt/høye   -- tall, high, loud : det høye slottet -- the high castle
høyt            -- highly, loudly
høyere          -- higher, taller
høyest          -- highest, loudest
høyre           -- right : (til hoyre -- to the right)
venstre         -- left : til venstre
drikker/å drikke -- to drink, drinking : ikke drikk -- dont drink
en drikk/drikken/drikker/drikkene -- the drink :
drakk           -- drank
vannen          -- water : vann/vannen
et vann/vannet  -- the water : jenta drikker vannet -- the girl is drining the water
et egg/egget/egger/eggene -- the egg
en kafe/kaféen  -- the cafeshop
en kaffe/kaffen -- the coffee drink
kaffemaskiner   -- the coffee machine
melken          -- the milk : en melk/melken/ kaffe med melk
et øl/ølet      -- the beer
stor/stort/store -- big : et stort hus, den store sengen -- the big bed
større          -- bigger : større enn -- bigger than
størst          -- the biggest : største rommet -- biggest room
små             -- small : små ting -- small things
lite            -- small : en liten gutt
litt            -- a little : litt nervos -- a little nervous : lite tid -- little time
litten          -- little : det er litten a gjøre her -- there is little to do here
billig/billige  -- cheap : (-e pl)
billiger/billigere -- cheaper : (-e pl)
billigst        -- the cheapest
dyr/dyrt/dyre   -- expensive : (dear), et dyrt hus, billetene er dyre, dyre agurkene -- expensive cucumbers
dyrere          -- more expensive
dyrest          -- most expensive
et dyr/dyret/dyr/dyrene -- the animal
ofte            -- often
oftere          -- more often
aldri           -- never : lager aldri mat -- never cooks
av og til       -- sometimes
og              -- and
eller           -- or
borte           -- away, gone : der borte -- over here , hun er borte -- she is gone
lang/lange/langt-- far, long : langt borte -- far away , vi har en lang katt -- we have a long cat
Norge           -- Norway
norsk           -- norwegian : snakker norsk
Sverige         -- Sweden
fra             -- from : kommer fra -- come from, fra to til fire -- from two till four o'clock
kommer          -- to come: arrive : kommer frem -- arrive
kom             -- came : hva kom først -- what came first
kommet          -- come : har kommet -- had come
kommer til      -- going to : vi kommer til å bruke alt -- were going to use everything
svømmer/å svømme -- to swim
svømmet         -- swam : har svømmet
svømte          -- swam : did swim
svømt           -- swam : har svømt -- has swam
bor/å bo        -- to live, stay : vi bor på hotell -- ne po rrime ne hotel
bodd            -- lived : har bodd
bodde           -- lived : did live
vet/å vite      -- to know : du må bare vite -- you must only know
visst           -- known : hadde du visst -- had you known
visste          -- knew : did know
skriver/å skrive -- to write
skrev           -- wrote : did write, was writing
skrevet         -- wrote : har skrevet -- has written
skrivere        -- the printers
leser/å lese    -- to read
leste           -- read : did read
lest            -- read : har lest -- have read
lærer/å lære    -- to learn : går i lære som ... -- do an apprenticeship as a
lært            -- learned : har lært
en lærer/læreren/lærerer/lærerne -- the teacher : (easy search larer)
snakker/å snakke -- to speak : snakker engelsk -- speak english : ikke snakk -- don't speak
snakket         -- spoke : did speak, har snakket -- have spoken
et språk/språket/språker/språkene -- the language
forstår/å forstå -- to understand : forstår norsk
forstod         -- understood
et land/landet/land -- the country
en landsby/landsbyen -- the village
en by/byen      -- the city
en te/teen      -- the tea
en katt/katten/katter/kattene -- the cat
en hund/hunden/hunder/hundene -- the dog
et brød/brødet  -- the bread
en bror/broren  -- the brother
brødre/brødrene -- the brothers
en mor/moren    -- the mother : also mora mi
mødre/mødre     -- the mothers
en far/faren    -- the father
fedre/fedrene   -- the fathers
en sønn/sønnen/sønner/sønnene -- the son :  (easy find sonnen)
en søster/søsteren/søstre/søstrene -- the sister :  (easy search : sosteren) (søstera)
et søsken/søskenet/søskner/søsknene -- the sibling : (easy search : sosken)
en datter/datteren -- the daughter : (dattera mi)
døtre/døtrene   -- the daughters
en gutt/gutten/gutter/guttene -- the boy
en kvinne/kvinnen/kvinner/kvinnene -- the woman
kvinneklær      -- woman clothing
en man/mannen/menn/mennen -- the man, husband : men - menn
man             -- you (one): people : Man trenger vann -- you (one, people) need water
en kone/konnen/koner/konnene -- the wife
en jente/jenta/jenter/jentene -- the girl : jentas -- of the girl
hvordan går det -- how goes it
det går bra     -- it goes well
går det bra?    -- goes it well
det             -- that : ja, det kan du -- yes you can, ja det har vi -- yes we have,
god morgen      -- good morning
god dag         -- good afternoon
god kveld       -- good evening
en morgen/morgenen/morgener/morgenene -- the morning
morgnen         -- morgnings
morgningen      -- the morning
en kveld/kvelden/kvelder/kveldene -- the evening
jeg             -- I : jeg har, jag er -- une kam, une jam
du              -- you
han             -- he
hun             -- she
vi              -- we
dere            -- you
de              -- they
meg             -- me : (mua)
har på seg      -- is wearing : (har pa meg) : vi har pa oss, dere har pa dere
deg             -- you : (ty)
seg             -- itself : self (me vete)
ham             -- him :(ate)
henne           -- her :(ate)
dem             -- them
deres           -- yours, theirs
oss             -- us
min/mine/mitt   -- mine
din/dine/dit    -- yours
hans            -- his
hennes          -- hers
sin/sitt/sine   -- own's : e vetja (its/his/her (their) own)
vår/vårt/våre   -- our : vår dor, barnet vårt, romene våre (easy search var vart vare)
én/ett          -- one
to              -- two
tre             -- three
fire            -- four
fem             -- five
seks            -- six
sju             -- seven
åtte            -- eight
ni              -- nine
ti              -- ten
elleve          -- eleven
tolv            -- twelve
tretten         -- thirteen
fjorten         -- fourteen
femten          -- fifteen
seksten         -- sixteen
sytten          -- seventeen
atten           -- eighteen
nitten          -- nineteen
tjue            -- twenty : tyve (twenty)
tretti          -- thirty
forti           -- fourty
femti           -- fifty
seksti          -- sixty
sytti           -- seventy
atti            -- eighty
nitti           -- ninety
hundre          -- hundred : hundert
tusen           -- thousand
tjueen          -- twentyone
tjueto          -- twentytwo
tjuetre         -- twentythree
tjuefire        -- twentyfour
tjuefem         -- twentyfive
tjueseks        -- twentysix
tjuesju         -- twentyseven
tjueåtte        -- twentyeight
tjueni          -- twentynine
første/først    -- first
andre           -- second, other people
den andre       -- the other
tredje          -- third
fjerde          -- fourth
femte           -- fifth
sjette          -- sixth
sjuende         -- seventh
åttende         -- eighth
niende          -- ninth
tiende          -- tenth
ellevte         -- eleventh
tolvte          -- twelvth
trettende       -- thirteenth
fjortende       -- fourteenth
femtende        -- fifteenth
sekstende       -- sixteenth
syttende        -- seventeenth
attende         -- eightteenth
nittende        -- nineteenth
mandag          -- Monday
tirsdag         -- Tuesday
onsdag          -- Wednessday
torsdag         -- Thursday
fredag          -- Friday
lørdag          -- Saturday
sondag          -- Sunday
lørdagen        -- the Saturday : (denne lørdagen -- this saturday)
på mandager     -- mondays
et morsmål/morsmålet -- the mothertongue: native language : (easy search morsmalet)
en stasjon/stajonen -- the station
et bibliotek/biblioteket -- the library
en park/parken/parker/parkene -- the park
en kirk/kirken/kirker/kirkene -- the church
et hotell/hotellet/hoteller/hotellene -- the hotel
et hotellromm/hotellrommet -- the hotel room
et museum/museet/museer/museene -- the museum
en meny/menyen  -- the menu
en venn/vennen/venner/vennene -- the friend
vennlig/vennlige -- friendly : (pl)
en matbutikk/matbutikken -- the grocery store
en butikk/butikken/butikker/butikkene -- the store
en kino/kinoen  -- the cinema
et apotek/apoteket -- the pharmacy
et bakeri/bakeriet -- the bakery
baker/å bake       -- to bake
baker           -- a baker
ung/ungt/unge   -- young : (t-et, e-pl)
unge            -- the young : youth
yngre           -- younger
gammel/gammelt/gamle -- old : gammelt hus, den gamle huset
eldre           -- older
ny/nye/nytt     -- new: : ny bil -- new car, nytt hus -- new house
nyere           -- newer
en minibank/minibanken -- the ATM
en bank/banken  -- the bank 
journalist      -- a journalist
en advokat/advokaten/advokater/advokatene -- a lawyer
et universitet/universitetet -- the university
januar          -- January
februar         -- February
mars            -- Mars
april           -- April
mai             -- May
juni            -- June
juli            -- July
august          -- August
september       -- September
oktober         -- Oktober
november        -- November
desember        -- December
et år/året/år/årene -- the year : åtte år gammel -- eight years old (easy search aret)
årets           -- year`s: of the year
en uke/uken/uker -- the week
en måned/måneden/måneder/månedene -- the month : (easy search: maned)
en banan/bananen/bananer/bananene -- the bannana
et eple/eplet/epler/eplene-- the apple
en salat/salaten/?/salatene -- the salad, letuce
i               -- in : i Olso , jag har vært syk i to uker -- i have been sick for two weeks
i en time       -- for an hour : vi danset sammen i flere timer -- we danced together for several hours
inn/inne        -- inside : han er inne -- he's inside : de kjorer inn i et tre -- they are driving into a tree
ut/ute          -- outside : hun går ut -- she's going out
utenfor         -- outside, outside of : utenfor huset -- outside the house
utenlandske/utenlandsk -- foreign : utenlandske personer -- foreign people
uten            -- without : uten deg, er jeg ingenting -- without you, i am nothing
på              -- at, on : på jobb -- at work , på bordet -- on the table
til             -- to, of : skrike til  -- yell to, kaken til moren min -- min morens kake -- keku i mamase time
i Norge         -- in Norway
i dag           -- today
i går           -- yesterday : dje, var det sol i gar? -- was it sunny yesterday?
i forgårs       -- day before yesterday: pardje
i morges        -- this morning
i morgen        -- tomorrow: nesër
i overmorgen    -- day after tomorrow
i år            -- this year
i fjor          -- last year : i hele fjor -- all of last year
i nærheten      -- nearby : (easy search nerheten narheten)
nær/nærme       -- near : (pl)
nærmest         -- nearest
en tid/tiden    -- the time : har du tid
gjør/å gjøre    -- to do : hva gjør du (easy search gjor/gjore)
gjort           -- done : har gjort
gjorde          -- did : did do : gjorde du det -- did you do it?
hos             -- at, with : oppe hos -- up at , bli hos meg -- stay with me
møter/å møte    -- to meet : møter opp -- meet up (easy search mote)
et møte/møtet/møter -- the meeting
møtte           -- met : jeg møtte begge to -- i met both
møtt            -- have met : har du møtt bandet -- have you met the band?
mot             -- to, towards, against : hun gjøre det mot meg -- she did that to me
kan             -- can : kan ikke  -- can not
står/å stå      -- to stand, stay : bordet står her -- the table is here, de står -- they are standing (easy search: star)
stod            -- stood
står opp/å stå opp -- to get up, stand, wake
bli             -- to stay, to become : bli i sengen (stay in bed), jeg vil bli lærer -- I want to become a teacher
ble             -- was
blitt           -- been : har blitt -- has become
en gate/gaten/gater/gatene/gata -- the street : på gata -- on the street
skrike/å skrike -- to yell
et skrik/skriket -- the scream
halv            -- half : halv ni -- 8:30
halvparted      -- half of
kvart           -- quarter
prater/å prate  -- to talk, chat : å prate om -- to talk about
pratet          -- talked : did talk, har pratet med -- has talked to
en prat/praten  -- the chat
glemmer/å glem  -- to forget : glem henne -- forget her
glemt           -- forgotten : har glemt
glemte          -- forgot
husker/å huske  -- to remember
husket          -- remembered : did remember
prøv            -- to try
prøvde          -- tried
en prøv/prøven/prøver/prøvene -- the test, exam
en kjekse/kjeksen/kjeks/kjeksene -- the cookie
et kjæledyr/kjæledyret/kjæledyrer/kjæledyrene -- the pet : (easy search : kjaledyr)
kjære           -- dear : kjære leser -- dear reader
en kjæreste/kjæresten -- the sweetheart, boyfriend, girlfriend
kjærlighet      -- the love
kjekke          -- handsome
kjedelig/kjedelige -- boring : jeg har det kjedelig -- i'm bored
et kjøkken/kjøkkenet/kjøkkener/kjøkkenene -- the kitchen
en kjole/kjolen/kjoler/kjolene -- the dress
et kjøleskap/kjøleskapet/kjøleskaper/kjøleskapene -- the refrigerator
kjøle           -- cool
et skape/skapet/skaper/skapene -- closet  : skapet er fullt av ting -- the closet is full of things
kjøpe/å kjøpe   -- to buy : kjøp dette -- buy this (easy search: kjope)
et kjøpesenter/kjøpesenteret -- the shopping center, mall
kjøpte          -- bought : vi har kjøpt et hus -- we have bought a house
kjører/å kjøre  -- to drive : kjøre oss ned -- drive us down (easy search kjorer) : kjør sakte -- drive slowly
kjørte          -- drove
et kjøtt/kjøttet -- the meat : (easy search: kjottet) jeg spiser kjottet
klær/klæren/klærne -- clothes :  (easy search: klaer)
en klesbutikk/klesbutikken/klesbutikker/klesbutikkene -- the clothing store
kler            -- to get dressed : jeg kler på meg -- i'm getting dressed
kledd           -- dressed, clothed
kjempe          -- giant
kjempefint      -- terrific
kjempetungt     -- really heavy : very heavy
kjempestor      -- really big
kjempevarmt     -- really warm
kjempelangt     -- really long
kjenner/å kjenne -- to know : njoh : jeg kjenner du
kjent/kjente    -- known : -e pl
ukjent          -- unknown
et kjed/kjedet  -- the chain, necklace
en krefte/kreften/kreftene -- the force, craft, power
et uhell/uhellet -- the accident : misshap
en ulykke/ulykken -- the accident
kødder du       -- are you f*cking
hele/helt       -- whole, totally, completely : hele tida -- all the time , hele dagen -- the whole day
sikker/sikkert/sikre -- surely: me siguri : helt sikkert -- definitely
forsiktig/forsiktige -- careful
neste           -- next : (adj)
nesten          -- almost : (adv)
det eneste      -- the only thing
seg selv        -- them selves
holder/å holde  -- hold, keep : du holder på med -- you're holding on to me
alt             -- everything : takk for alt -- thanks for everything
alle            -- all, everybody : alle koppene -- all the cups
altså           -- so, therefore
spiser/å spise  -- to eat
spiste          -- ate : did eat : spiste du -- did you eat?
spist           -- eaten : har spist, har du spist -- have you eaten?
så              -- so, therefore : så mye -- so much
må              -- must, have to : (easy search: ma), må til -- must go to
måtte           -- had to
måte            -- way, manner : i like måte -- likewise (same way)
jo              -- on the contrary : yes ????? go (jo til legen  -- go to the doctor)
faen            -- f*ck : sh!t
dårlig/darlige  -- bad : darlig tid -- poor time
verre           -- worse : verre ting -- worse things
verst/verste    -- worst : den verste -- the worst
fattig          -- poor
stakkars        -- poor : stakkars deg! -- poor you!
rik             -- rich
titte           -- peek, check out
tur             -- turn, walk : gå på tur -- go on walks
en tur/turen/turer/turene -- the trip : the walk : gud tur! -- have a nice trip!
fjelltur        -- mountain hike
teltur          -- camping trip
til a handle    -- to act
elsker          -- to love : jeg elsker du
får/å få        -- to get : må få -- must get : får det fint -- will be fine
fått            -- got
fikk            -- got : fikk ikke fortalt  -- was not told
forresten       -- by the way
som             -- like, which : du er som oss -- you are like us : ingen er så god som du -- noone is as good as you
brenner         -- burns
skjer/å skje    -- to happen
skjedde         -- happened : hva skjedde -- what happened : hva har skjedd -- what has happened : (hva som skjedd -- what happened)
skjedd          -- happened : har det skjedd ham noe -- has something happened to him?
hjemme          -- at home : han er ikke hjemme -- he's not at home
et hjem/hjemmet -- the home : katt søker nytt hjem -- cat is looking for a new home
en nyhet/nyheten/nyheter/nyhetene -- the news : (den gode nyheten -- the good news) 
en avis/avisen/aviser/avisene -- newspaper :  (avisa)
nå              -- now
sen/sent        -- late : sent (-et) : du er sen -- you are late, det er sent -- it's late, det er for sent -- it's too late
senere          -- later
senest          -- latest
av              -- of : (en av dem -- one of them)
tror            -- believe : tror du -- do you think?
en drit/dritten -- shit
selvfølgelig    -- surely : of course
fortsatt        -- still
fortsetter      -- to continue
fortsatte       -- continued : did continue
ennå            -- yet : ikke ennå -- not yet
fort            -- fast, quickly : hun kjører fort -- she drives fast
rask/raskt/raske -- fast
raskest         -- the fastest
sann/sant/sanne -- true : (ikke sant? -- isn't it right?)
evige           -- eternal
en ild/ilden/ilder/ildene -- fire : (evige ilden  -- eternal fire)
bryter/å bryte  -- to break, switch : (bryte inn -- break inn) ; bryte -- break up
brukket         -- broken
mens            -- while
makt            -- power : (makt til folket -- power to the people)
finne           -- find
fant            -- found : fant han huset -- did he find the house?
funnet          -- found : har funnet -- have found
en forelder/forelderen/foreldre/foreldrene -- the parent
en besteforelder/besteforelderen/besteforelderene -- the grandparent
en bursdag/bursdagen/bursdager/bursdagene -- the birthday
et burgsdagskort/bursdagskortet/bursdagskorter/bursdagskortene -- the birthday card
en dag/dagen/dager/dagene -- the day : senere på dagen -- later in the day
en natt/natten/netter/nettene -- the night : god natt -- good night
midnatt         -- midnight : etter midnatt -- after midnight
redd/redde      -- afraid : (-e pl), redd for -- afraid of
egentlig        -- really, actually : for egentlig -- for real
virkelig        -- really, truly
siden           -- since, ago : beina mine har gjort vondt siden lørdag -- my legs have hurt since saturday, for en uke siden -- a week ago
losningen       -- the solution
en frokost/frokosten -- the breakfast : spis frokosten din -- eat your breakfast
en lunsj/lunsjen -- the lunch
en middag/middagen/middager/midaggene -- the dinner
kveldsmat       -- supper
sier/å si       -- to say : hva sier dere -- what do you say, si noe -- say something
sa              -- said : did say, hva sa du -- what did you say?
sagt            -- said : har sagt -- have said
si ifra         -- let me know: speak out : han er redd for a si ifra -- he is afraid of speaking out
ifra            -- from
tenker/å tenke  -- to think: tenker på meg -- think about me
tenkte          -- thought
gjerne          -- like, gladly : deutsch gern : jeg vil ha det gjerne
vil             -- to want, will : vil du -- do you want to?
ville           -- wanted, would: wille visst -- would know
skal            -- shall, will, going to : hvor skal du i dag -- where are you going today, hva skal du gjøre? -- what are you going to do?
skulle          -- would : skulle til -- would go to
burde           -- should : du burde visst det -- you should have known that
en skjorte/skjorten/skjorter -- the shirt : skjorta, T-skjorta
et skjørt/skjørtet -- the skirt
en sko/skoen/sko/skoene -- the shoe
joggerskoen     -- the sneakers
en genser/genseren/genserne -- the sweater
et intervju/intervjuet -- the interview : jeg trenger nye kler til intervjuet -- i need new clothes for the interview
tar/å ta        -- to take, catch : ta med -- (take with) bring ;
tar med         -- to bring
tar på          -- touch
tatt            -- taken, cought : har tatt, bli tatt -- be caught, De har tatt henne -- they have taken her
i det hele tatt -- at all
tok             -- took : did take, de tok t-banen -- they took the subway, tok telefonen -- pick up the phone, tok du med tingene -- did you bring the things?
tok med         -- brought
mottar/å motta  -- to receive
mottatt         -- received : har mottat
mottok          -- received : did receive
stedet          -- instead : jeg spiser is i stedet for frukt -- i eat icecrem instead of fruit
et sted         -- place, somewhere : (i steded for -- in place of/instead), et annet sted -- somewhere else
skylle/å skylle -- to rinse, flush
ned             -- down : (ned i do -- down the toilet)
første          -- first
en gang/gangen/ganger/gangene -- the time : hera (første gang -- first time) :  noen ganger -- sometimes, med en gang -- immediately (me një herë)
noen gang       -- any time : ever, ndonjehere
en time/timen/timer/timene -- the hour, class, appointment: en time -- an hour
sangtimer       -- singing classes
en gang/gangen/ganger/gangene  -- the hallway
noe             -- something
noen            -- some, any : (one/thing) : jeg ser noen kvinner -- i see some women, har du noen poser -- do you have any bags
noens           -- somebody's
ingenting       -- nothing : takk for ingenting -- thanks for nothing
ingen           -- noone : jeg er ingen mann -- i'm no man
en ting/tingen/tinger/tingene -- the thing : ting tar tid -- things take time
varet           -- the weather
sol             -- me diell, sunny : det er sol (sola)
en sol/solen    -- the sun
regner          -- to rain : det regner, regner jeg med -- I reckon
snør            -- to snow : det snør
snødde          -- snowed : did snow
snøen           -- the snow : en snø/snøen
overskyet       -- me re, cloudy : det er overskyet
en vår/våren    -- the spring : det or snart vår -- it is spring soon (easy search: varen), en vår med sol -- a spring with sunshine
en sommer/sommeren -- the summer
en høst/høsten -- the fall, autumn
en vinter/vinteren -- the winter
kald/kaldt/kaldene -- cold : det er kaldt : kaldere -- colder
varm/varmt/varme -- hot : det er varmt
synger/å synge  -- to sing
en sang/sangen/sanger/sangene -- the song
et kor/koret    -- the choir
alltid          -- always
jogger/å jogge  -- to jog
en hånd/hånden  -- the hand : gi meg hånden din -- give me your hand
fots            -- foot : gå til fots -- go on foot
fotball         -- futboll : spiler fotball
en kamp/kampen/kamper/kampene -- the match, game, fight, battle
fotballkampen   -- the football match
en ball/ballen  -- the ball
liker/å like    -- to like, enjoy
likte           -- liked : did like
likt            -- liked : har likt -- has liked
en seng/sengen  -- the bed :   (ei seng)
et toalett/toalettet/toaletter/toalettene -- the restroom
et bad/badet    -- the bath, bathroom : å ta et bad -- to take a bath
bader/å bade    -- to bathe
baderommet      -- the bathroom
en badedrakte/badedrakten -- the swimsuit
ren/rent/rene   -- clean : (-et, -e pl) : et rent hus, gatene er rene
en restaurant/restauranten/restauranter -- the restaurant
en romkamerat/romkameraten/romkamerater -- the roommate
et soverom/soverommet -- the bedroom
sover/å sove    -- to sleep, is sleeping : sover du - are you sleeping
sov             -- slept : did sleep, fjeta, was sleeping
sovet           -- slept : have slept
sovner          -- to fall asleep
sovnet          -- fell asleep
trøtt           -- tired
sliten/slitne   -- tired : (-e pl)
en billett/billeten/billeter/billetene -- the ticket : tur retur billett -- round trip ticket
et tog/toget    -- the train : tog - trains
bestiller/å bestille -- to order
avbestiller/å avbestille -- to cancel
en bestilling/bestillingen -- the order
betaler/å betale -- to pay : du kan betale
kontant         -- cash : betaler kontant -- pay cash
en kort/korten/kort -- card, credit card
en kredittkort/kredittkorten -- the credit card
appen           -- the application : on the phone en app/appen
en minutt/minutten/minutter/minuttene -- the minute
klokka          -- time (clock)
tid             -- time : neste tid (neste gang)
et bord/bordet/bord/bordene -- the table
et skrivebord/skrivebordet -- the desk
en leilighet/leiligheten/leiligheter -- the apartment
et hus/huset/hus/husene -- the house
en stol/stolen  -- the chair
et set/setet    -- the seat
stygg/stygt/stygge -- ugly : et stygt hus, stygge hus
for             -- too much, a lot : for stygt -- too ulgy (for also means for, at, what, and because)
for tiden       -- currently, at this time
på tide         -- time to : det er på tide å dra -- it's time to go
vakker/vakkert/vakre -- beautiful : (pl) : et vakkert hus, vakre blomstene
nettopp         -- exactly, just : de var her nettopp -- they were just here.
flott/flotte    -- great : (pl)
fin/fint/fine   -- nice : fine hus -- nice houses
en størrelse/størrelsen/størrelser/størrelsene -- the (clothes) size
leter           -- to look, looking
etter           -- for, after : leter etter -- search/look for, leter du etter (i ettermiddag  -- in the afternoon)
etterpå         -- afterwards : dagen etterpå -- the day after
åpen/åpent/åpne -- open :  (-e pl) vinduet er åpnet
åpner/å åpne    -- to open : åpne doren! -- open the door! 
åpnet           -- opened
trenger/å trenge -- to need
trengte         -- needed
finner/å finne  -- to find
fant            -- found
finner sted     -- to take place
finner oss      -- to tolerate
fant sted       -- took place
en avgang/avgangen -- the departure
en onkel/onkelen/onkeler/onkelene -- the uncle
fantastisk      -- fantastic
en hylle/hyllen -- the shelf
et teppe/teppet -- the carpet
et teppe/teppet -- the blanket
blir/å bli      -- to become : come up to, costs, make : det blir -- that makes, jeg blir maler -- i'll be a painter, jenta blir en kvinne -- the girl is becomming a woman.
blir du med     -- are you comming along, will you become
ledig           -- free, available
forsinket       -- delayed
bestefar/farfar/farmor -- grandfather
bestemor/mormor/morfar -- grandmother
søt/søtt/søtte  -- sweet
søtere          -- sweeter
søtest          -- the sweetest
sukker          -- sugar
rett            -- straight
frem            -- ahead : rett frem -- straight ahead
en dyrehage/dyrehagen -- the zoo
en elv/elven/elver/elvene/elva -- the river
besøker/å besøke -- to visit : hvem er dere på besøk hos? -- who are you visiting with? : får besøk -- take visitors
en besøk/besøken/besøk/besøkene -- the visitor :  (easy search besok)
besøkt          -- visited : har besøkt
besøkte         -- visited : did visit
sentrum         -- center : i sentrum -- in the city center
sulten/sultent/sultne -- hungry : de er sultne
tørst/tørste    -- thirsty : (easy torst)
en buss/bussen/busser/bussene -- the bus
bussholdeplassen -- the bus stop
bussbilleten    -- the bus ticket
busstasjonen    -- the bus station
togstasjonen    -- the train station
penger/pengene  -- the money : pengene mine -- my money : trenger penger -- need money
et nummer/nummeret/numre/numrene -- the number
en taxi/taxien -- the taxi
en taxitur/taxituren -- the taxiride
en adress/adressen/adresser/adressene -- the adress
gjentar/å gjenta -- to repeat : historien gjentar seg -- history repeats itself
deler/å dele    -- to split, divide, share : deler reiginingen -- split the bill, deler tiden med -- share time with
en del/delen/deler/delene -- the piece, part
en familie/familien/familier/familiene -- the family
en supp/suppen/supper/suppene -- the soup
nervøs          -- nervous
et hode/hodet/hoder/hodene -- the head
vond/vondt      -- hurt, pain : en vond fot -- a sore foot; vondt i hodet -- headache : det gjør vondt -- it hurts (easy search gjor vondt)
trist/triste    -- sad
glad/glade      -- happy : (-e m, pl) : jeg er glad i deg -- I love you!
mindre          -- less, smaller : mer eller mindre -- more or less
minste          -- smallest, least : den miste leiligheten -- the smallest appartment
minst           -- at least : du må vente minst en time -- you must wait at least an hour
i hvert fall    -- at least, in any case
smaker/å smake  -- to taste, tastes
et håp/håpet    -- the hope
håper/å håpe    -- to hope : håper det smaker -- hope it tastes good (enjoy your meal)
forhåpentligvis -- hopefully
et glass/glass/glassene -- the glass
en fest/festen  -- the party
fester/å feste  -- to party
festet          -- partied
en brus/brusen  -- the soda
en invitasjon/invitasjonen/invitasjoner/invitasjonene -- the invitation
rodvinen        -- the read wine
hjemme          -- home : jeg er hjemme
hurra           -- urra, horay, hooray
et band/bandet  -- the band
en ballong/ballongen -- the balloon
en klov/klovnen -- the clown
en gjest/gjesten/gjester/gjestene -- the guest
en gave/gaven   -- the gift
lar/å la        -- to let : la oss -- let us
lott            -- let : did let
danser/å danse  -- to dance : la oss donse -- let us dance
danset          -- danced
feirer/å feire  -- to celebrate : la oss feire -- let us celebrate
en musik/musiken -- the music : jeg hører på musikk
et navn/navnet/navn/navnene -- the name : vi har mange navn å velge fra -- we have many names to choose from
et fornavn/fornavnet -- the first name
et etternavn/etternavnet -- the last name
bedring         -- recovery : god bedring -- feel better
en feber/feberen/feber/feberne -- fever
frisk           -- healthy
lenger          -- anymore : ikke ... lenger
lenge           -- long : hvor lenge -- how long
en festival/festivalen -- the festival
starter/å starte/start -- to start, initiate, launch : start bilen!
startet         -- started
begynner/å begynne -- to begin
begynte         -- began
slutter/å slutte -- to end, stop, quit
en slutt/slutten -- the end
avslutter/å avslutte -- to finish
til slutt       -- finally
studerer/å studere -- to study
studerte        -- studied
drar/å dra      -- to go, leave : drar på telttur -- go camping
en skog/skogen  -- the forest
en skogkatt/skogkatten -- the forest cat
dessverre       -- unfortunately
allerede        -- already
en lyst/lysten/lyster/lystene -- the desire : jeg har lyst på is -- i want icecream
lys/lyst        -- bright, light : lys hud -- fair skin
et lys/lyset    -- the light
lyse            -- to light
en plan/planen/planer/planene -- the plan
et instrument/instrumentet/instrumenter -- the instrument
videospill      -- videogame
podkast/podcaster -- podcast
en grill/grillen -- the grill
griller/å grille -- to grill
grillet         -- grilled
en grillfeste/grillfesten -- the barbequeue
skitten         -- dirty
en baby/babyen  -- the baby
et barn/barnet/barn/barna -- the child : det er barnets te -- that the child's tea.}}+
et barnebarn/barnebarnet/barnebarn/barnebarna -- the grandchild
en historie/historien/historier/historiene -- the history
fransk          -- french
amerikansk/amerikanske -- american : (-e pl)
svensk          -- swedish
en student/studenten/studenter/studentene -- the student
en fiolin/fiolinen -- the violin
en hobby/hobbyen/hobbyer -- the hobby
tennis          -- tennis
et pariserhjul/pariserhjulet -- the ferris wheel
tidlig          -- early : (like timely? timely is betimelig)
tidligere       -- earlier
pommes fritesen -- the fried potatoes, french fries
trener          -- to train, exercise : å trene
en kopp/koppen/kopper/koppene -- the cup
en yoghurt/yoghurten -- the yogurt
frokostblanding -- cereal
en ris/risen    -- the rice
en is/isen      -- the ice, icecream
en kylling/kyllingen/kyllinger/kyllingene -- the chicken
en hage/hagen   -- the garden
alene           -- alone : gå aldri alene -- never go alone
sammen          -- together : tilbringer tid sammen -- spend time together
en trapp/trappen-- the staircase, stairs
et kollektiv/kollektivet -- the shared apartment
et leilighetsbygg/leilighetsbygget -- the apartment building
hvit/hvitt/hvite -- white : et hvitt hus
svart/svarte    -- black : (-e pl) -- svarte sko - black shoes
rød/rødt/røde   -- red :  (-e pl) : røde pærer -- red pears (easy search rod)
grønn/grønt/grønne -- green :  huset er grønt
lilla           -- purple
lyselilla       -- light purple
oransje         -- orange color
gul/gult/gule   -- yellow : huset er gult
grå/grått/grå   -- gray : det er grått -- its gray, byen er ful av grå hus -- the city is full of gray houses
blå/blått/blå   -- blue : et blått hus
lyseblå         -- light blue
rosa            -- pink
brun/brunt/brune-- brown
en grønnsak/grønnsaken/grønnsaker/grønnsakene -- the vegetable
en nabo/naboen  -- the neighbor
et nabolag/nabolaget -- the neighborhood
skit/skitne     -- dirty : skitne (pl)
stille          -- quiet
stillere        -- quieter
foretrekker     -- prefer
en vase/vasen   -- the vase
en blomst/blomsten/blomster/blomstene -- the flower
en boke/boken/bøker/bøkene -- the book: (easy search boken) (boka si -- her book)
en stu/stuen/stuer/stuene -- the living room
en spisestue/spisestuen/spisestuer/spisestuene -- the diningroom
en plante/planten/planter/plantene -- the plant
en pute/puten/puter/putene -- the pillow
myk/mykt/myke    -- soft : myke putene
en dyne/dynen/dyner/dynene -- the dyvet: batanije
en mikrobølgeovne/mikrobølgeovnen/mikrobølgeovner/mikrobølgeovnene -- the microwave oven
en ovne/ovnen   -- the oven
et enkeltrom/enkeltrommet/enkeltrommer/enkeltromene -- the single room
enkelt          -- single
et dobbleromme/dobbletrommet -- the double room
dobbel          -- double
en nøkkel/nøkkelen/nøkler/nøklene -- the key
et rom/rommet/rommer/rommene -- the room
en bar/baren    -- the bar
en strand/stranden/strender/strendene -- the beach : pa stranden -- on the beach, vakre strender -- nice beaches
et fly/flyet/flyer/flyene -- the airplane
en flyplass/flyplassen/flyplaser/flyplassene -- the airport
en flybillete/flybilleten -- the plane ticket
en bokhandel/bokhandelen/bokhandeler/bokhandelene -- the bookstore
en utflukt/utflukten/utflukter/utfluktene -- the excursion
en ettermiddag/ettermiddagen/ettermiddager/ettermiddagene -- the afternoon
en respsjon/respsjonen/respsjoner/respsjonene -- the reception desk
en balkong/balkongen/balkonger/balkongene -- the balcony
et treningssenter/treningssenteret/treningssenterer/treningssenterene -- the gym
et vindu/vinduet/vinduer/vinduene -- the window
en dør/døren/dører/dørene-- the door
kjøkkendøren    -- the kitchen door
fungerer        -- to work : (funktioniert) : fungerer det? -- does it work?
en dusj/dusjen/dusjer/dusjene -- the shower
dusjer/å dusje  -- to shower
internett       -- the internet
nett            -- online, internet : på nett
ødelagt         -- broken
en pappa/pappaen-- the dad : baba,  : pappas -- father's
en mamma/mammaen-- the mama
en bil/bilen/biler/bilene -- the car
reiser/å reise  -- to travel
reiste          -- travelled : har reist -- have travelled
et kontor/kontoret/kontorer/kontorene -- the office
taco            -- taco
tacofredag      -- taco friday
en runstykk/runstykken/runstykker/runstykkene -- the rolls
en sjef/sjefen/sjefer/sjefene -- the boss
en motorsykkel/motorsykkelen/motorsykkeler/motorsykkelene -- the motorcycle
en sykkel/sykkelen/sykler/syklene -- the bicycle
gift            -- married
førnoyd         -- content, pleased
pepper          -- pepper
et salt/saltet/salter/saltene -- the salt
salt            -- salty : suppen er for salt -- the soup is too salty
saltest         -- the saltiest
en tomat/tomaten/tomater/tomatene -- the tomato
en frukt/frukten/frukter/fruktene -- the fruit
en favorittmat/favorittmaten -- the favorite food
allergisk       -- the allergic: allergisk mot -- allergic to
et nøt/nøtten/nøtter/nøttene -- the nut: arra
en saus/sausen/sauser/sausene -- the sauce
senep           -- mustard
en grønsak/grønsaken/grønsaker/grønsakene -- the vegetable
en spinat/spinaten -- the spinach
en flaske/flasken/flasker/flaskene -- the bottle
en sjokolade/sjokoladen -- the choccoloate bar
fersk/ferske    -- fresh : ferske agurker -- fresh cucumbers
ferskvann       -- fresh watter
ferskest        -- the freshest
sunn/sunt/sunne -- healthy : sunn mat -- healthy food
igen            -- again : kom igen -- come on
et hjert/hjertet/hjerter/hjertene -- the heart
en tante/tanten/tanter/tantene -- the aunt
et fjell/fjellet/fjeller/fjellene -- the mountain
et basseng/bassenget/bassenger/bassengene -- the pool
en konsert/konserten/konserter/konsertene -- the concert
en lampe/lampen/lamper/lampene -- the lamp
en pasta/pastaen/pastaer/pastaene -- the pasta
mørk            -- dark
en dato/datoen/datoer/datoene -- the date
en date/daten/dater/datene -- the date : ta med en date -- bring a date
stenge/å stenge -- to close
stengte         -- closed: did close
stengt          -- closed : have closed -- har stengt
stengt/stengte  -- closed : butikkene er stengte, skoler er stengt
lukker/å lukke  -- to close : lukk dor!
lukket          -- closed
en legitimasjon/legitimasjonen/legitimasjoner/legitimasjonene -- identification
varer/å vare    -- to last : hvor lenge varer det -- how long does it last, konserten varer i tre timer -- koncert lasts three hours
varte           -- lasted : det varte i tre dager -- that lastet three days
være            -- to be : jeg vil være med deg -- i want to be with you (easy search vare)
vært            -- been : har vært -- have been,
kunne vært      -- could have been
en voksen/voksen/voksne/voksne -- the adult
vokser/å vokse  -- to grow up
filmen          -- the film : en film/filmen
en skrekkfilm/skrekkfilmen/skrekkfilmer/skrekkfilmene -- the horror film
skrekk          -- scary
en kalendar/kalendaren/kalendarer/kalendarene -- the calendar
kort/korte      -- short, quick : jakkene er korte -- the jackets are short (jakka)
et kamera/kameraet/kameraer/kameraene -- the photo camera
tilbringer/å tilbringe -- to spend : tilbringe tid -- spend time
tilbake         -- back : kom tilbake -- come back : må tilbake -- must return
bak             -- behind : bak doren -- behind the door
en lekse/leksen/lekser/leksene -- the homework
en ferie/ferien/ferier/feriene -- the vacation : gud ferie! -- have a nice vacation! : pa ferie -- on vacation
visum           -- the visa : visum/visumet
en toll/tollen/toller/tollene -- the customs
en penn/pennen/penner/pennene -- the pen : vi er tomme for blå penner -- we are out of blue pens
riktig          -- correct
et øyeblikk/øyeblikket/øyeblikk/øyeblikkene -- the moment : ikke for øyeblikket -- not at the moment
et øye/øyet/øyner/øynene -- the eye :  (easy search oye)
en blikk/blikken/blikker/blikkene -- the gaze
et skjema/skjemaet/skjemaer/skjemaene -- the form : formular
skinner/å skinne -- to shine : solen skinner -- the sun is shining
en ryggsekk/ryggsekken/ryggsekker/ryggsekkene -- the backpack
flyr/å fly      -- to fly
en hytte/hytten/hytter/hyttene -- the cabin
tung/tungt/tunge -- heavy : bordet er tungt -- the table is heavy
et problem/problemet/problemer/problemene -- the problem
en ordbok/ordboken/ordboker/ordbokene -- the dictionary
ordet           -- the word : et ord/ordet/ord/ordene
briller         -- the glasses : /briller/brillene
en koffert/kofferten/kofferter/koffertene -- the suitcase
et slott/slottet/slotter/slottene -- the castle
en turist/turisten/turister/turistene -- the turist
pakker/å pakke  -- to pack
pakken          -- the package : en pakke/pakken
full/fullt/fulle -- full : glasset er fullt, fulle glasser
sennep          -- mustard
mediterer       -- meditate
fordi           -- because
løper/å lope    -- to run : løp -- run!
våte/vatt       -- wet : de er vått ute -- its wet outside
maraton         -- marathon
meter           -- meter : meters : en meter//meter
kilometer       -- kilometer
sykler/å sykle  -- to ride : (bicycle) 
kjedelig         -- bored : jeg hard de skedlig,
snart           -- soon: shortly
endelig         -- finally: at last
slekt           -- kin, family
en slektninge/slektningen/slektninger/slektningene -- the relative
telefonnummer   -- telephone number
punktlig        -- punctual
spørsmålet      -- the question : et spørsmål/spørsmålet : et spørsmal om tid -- a question of time (easy search sporsmalet)
spør/å spørre   -- to ask :  (spor easy search)
spørt           -- asked
spor/å spore    -- to track, to trace
et spor/sporet/spor/sporene -- the track : følg disse spor -- follow these tracks
førerkort       -- drivers license : (easy search forerkort)
e_postadressen  -- the email : en e-postadresse/e-postadressen/
datamaskinen    -- the computer : en datamaskin/datamaskinen
null            -- zero, none
pausen          -- the pause, break : en pause/pausen, jeg trenger en pause -- i need a break
en kollegae/kollegaen/kollegaer/kollegaene -- the colleague
arbeidsledig    -- unemployed : (work available)
henter/å hente  -- to pick up : jeg henter henne -- i'm picking her up
en pose/posen/poser/posene -- the bag
en kurv/kurven/kurver/kurvene -- the basket
en appelsin/appelsinen/appelsiner/appelsinene -- the orange
gratis          -- gratis
en kunde/kunden/kunder/kundene -- the customer
en pære/pæren/pærer/pærene -- the pear
juicen          -- the juice : en juice/juicen
en kasse/kassen/kasser/kassene -- the cash register
en agurke/agurken/agurker/agurkene -- the cucumber
en kvittering/kvitteringen/kvitteringer/kvitteringene -- the recepit
selger/å selge  -- to sell
igjen           -- again : leiligheten er ryddig igjen -- the apartment is tidy again, jeg har ingenting igjen -- i have nothing left
en slakter/slakteren/slakterer/slakterene -- the butcher
et konditorie/konditoriet/konditorier/konditoriene -- the pastry shop
blomsterbutikken - the flower shop
sommerblomsten  -- the summer flowers
nok             -- enough
en hatt/hatten/hatter/hattene -- the hat
kul             -- cool
kulere          -- cooler
en jakke/jakken/jakker/jakkene -- the jacket
en veske/vesken/jesker/veskene -- the purse
en bukse/buksen/bukser/buksene -- the pants
en sokk/sokken/sokker/sokkene -- the sock
sandaler        -- the sandals : sandaler/sandalene
en kart/karten/karter/kartene -- the map : kart over byen -- map of the city
fyller/å fylle  -- to fill, turn : hvem fyller femty -- who is turning fifty
fylt            -- filled
inviterer/å invitere -- to invite
vasker/å vaske  -- to wash : jeg må vaske meg -- duhet të lahem, vask klærne dine -- wash your clothes
vasket          -- have washed : har du vasket deg -- have you washed yourself (u lave)?
sint            -- mad : jeg er sint -- I'm mad
leien           -- the rent : en leie/leien
leier           -- to rent : de leier sykler -- they are renting bikes
rotete          -- messy : rommet dit er rotete -- your room is messy
venter/å vent   -- to wait
ventende        -- waiting
lat/lat/late    -- lazy : jeg elsker late søndager -- i love lazy sundays
tilhører        -- to belong : bøkene tilhører oss -- the books belong to us
dagligvarene    -- the groceries: daglivarer/dagligvarene
sitter/å sitt   -- to sit
satt            -- sat : sat oss ned -- we sat down
tomme           -- empty : koppene er tomme -- the cups are empty, vi are tomme for brod -- we are out of bread
ferdig/ferdige  -- done : (-e pl), vi er ferdige -- we are done
høflig          -- polite
uhøflige        -- impolite : barna er så uhøflige -- the children are so impolite
et gulve/gulvet/gulver/gulvene -- the floor : ikke på gulvet! -- not on the floor!
eier/å eie      -- to own : hun eier hyttene -- she owns the cabins
eierne          -- the owners
huseier         -- the landlord
hjelpsomt/hjelpsomme -- helpful
ryddig          -- tidy
ryddigst        -- tidyest
rydder          -- to tidy
ryddet          -- tidied
et hysarbeide/hysarbeidet/hysarbeider/hysarbeidene -- the chore, housework
arbeidet        -- the work
kua             -- the cow : en ku/kua  ( ei ku)
spansk          -- spanish : spania -- spain
bagasjen        -- the luggage : en bagajse/bagajsen
Europa          -- europe
Asia            -- asia
ganske          -- quite : fairly : vi er ganske trøtte -- we are quite tired
sanden          -- the sand : en sand/sanden
verden          -- the world : en verden/verdenen
over            -- of, covering : kart over byen -- map of the city
over            -- finished : festen er over -- party's over
sjampanje       -- shampagne
bra jobba       -- well done
praktisk/praktiske -- practical
et tre/treet/trær/trærne -- the tree : eplertrærne -- apple trees
viser/å vise    -- to show : viser du meg -- show me
farlig/farlige  -- dangerous : (-e pl)
farligere       -- more dangerous
savner/å savne  -- to miss : jeg savner deg -- i miss you
gir/å gi        -- to give : vi gir og tar -- we give and take
ga              -- gave
gitt            -- given: har gitt
en skole/skolen/skoler/skolene -- the school
en post/posten  -- the mail
et postkontor/postkontoret -- the postoffice
en bygning/bygningen//bygningene -- the building
bruker/å bruke  -- to use: to spend, to wear : ikke bruke bilen -- dont use the car : bruker penger på -- spend money on
brukte          -- used, spent
bruk            -- use : gjøre bruk -- make use
favorittlaget   -- the favorite team
favorittbandet  -- the favorite band
en niese/niesen -- the niece
en nevø/nevøen  -- the nephew :  (easy search nevoen)
utsolgt         -- sold out : utsolgt for brød -- sold out of bread
et teater/teateret -- the theater
stadion         -- the stadium
t_banen         -- the subway : en t-bane/t-banen
slags           -- kind, type : hva slags -- what type
operaen         -- the opera : en opera/operaen
klassisk        -- the classical : klassisk musikk
inngangsbilleten - the admission ticket
ekte            -- real : ekte problem -- real problem
en ekteman/ektemannen -- the husband
ektepar         -- married couple
plass           -- place, space : vi har ikke plass til alt -- do dont have room for everything
en person/personen/personer/personene -- the person
handler/å handle -- to shop for, to act : vi handler øl -- we are shopping for beer
gratulerer      -- congratulations : gratulerer med dagen -- happy birthday!
gratulerer/å gratulere -- to congratulate
en overraskelse/overraskelsen/overraskelser/overraskelsene -- the surprise
overrasker      -- to surprise
ringer/å ringe  -- to ring : call by phone
ringte          -- called
et bryllup/bryllupet/bryllup/bryllupene -- the wedding
bryllupsdag     -- wedding anniversary
en rose/rosen   -- the rose flower
vinner/å vinne  -- to win : hvem vinner spillet -- who's winning the game?
vunnet          -- won : har vunnet -- has won
vant            -- won : did win
taper/å tape    -- to lose : a game
en sport/sporten/sport/sportene -- the sport
en radio/radioen-- the radio
dokumentarer    -- the documentaries
tegner/å tegne  -- to draw
tegnefilm       -- cartoon :tegnefilm/tegnefilmer/
hviler/å hvile  -- to rest
en partner/partneren -- the partner
en ambassade/ambassaden -- the embassy
ærend           -- erand : (easy search arend)
et passfoto/passfotoet -- the passport foto
et fødested/fødestedet -- the birthplace
fornyer/å fornye -- to renew
svarer/å svar   -- to answer : svar på -- answer to
svarte          -- answered : ingen svarte -- nobody answered
svart           -- have answered : de har ikke svart på telefonen -- they havent answered the phone
et svar/svaret  -- the answer
betyr/å bety    -- to mean : hva betyr det -- what does it mean?
betydning       -- meaning
hjelper/å hjelpe -- to help
en konto/kontoen/kontoer -- the account
en bankkonto/bankkontoen/bankkontoer -- the bank account
oppretter/å opprete -- to set up, start upp
årsak           -- worry, problem : ingen årsak -- no worries!
vanlig/vanlige  -- usual : : som vanlig -- as usual
vanligvis       -- usually : hunden er vanligvis vennlig -- the dog is usually frendly
en trikke/trikken/trikker -- the trams, tramvaj
overfører/å overføre -- to transfer, to transmit
en parkeringsplass/parkeringsplassen/parkeringsplasser/parkeringsplassene -- the parking place, parking lot
viktig/viktige  -- important : (-e pl)
pen/pene/pent   -- pretty, nice, handsome
definitivt      -- definitely
definitive      -- definite
et liv/livet/liv/livene -- the life
synes           -- to seem, think : de synes byen er pen -- they think the city is pretty
syntes          -- seemed
et syn          -- the view : i mitt syn -- in my view
enig            -- agree, in agreement : mange er enige med meg -- many agree with me
uenige          -- disagree
sannsynligvis   -- probably
sliten          -- exhausted
slitsom         -- exhausting
hater/å hate    -- to hate
hatet           -- hated
rar/rare/rartt  -- strange
forferdelig     -- terrible
en bestevennen/bestevennen -- the best friend
forkjølet       -- sick, cold : ftohur, jeg er forkjølet -- i'm sick (easy search forkjolet)
kunne           -- could : hvordan kunne du -- how could you?
en stemninge/stemningen -- the mood, atmosphere
forrige         -- previous, last : përpara : forrige helg -- previous weekend
hverandre       -- eachother, oneanother
bærer/å bære    -- to carry : (easy search bare)
flytter/å flytte -- to move : flytt fotene -- move your feet
flyttet         -- moved
en flytting/flyttingen -- the move
en arm/armen/armer/armene -- the arm
en rygg/ryggen  -- the back
en hend/henden/hender/hendene -- the hands : hendene i været! -- hands in the air!
en fot/foten/føtter/føttene -- the feet
begge/begge to  -- both
både            -- both
ro              -- peace
rolig           -- calm, calmly
urolig          -- disturbed
en gavekort/gavekorten -- the giftcard
et smørbrød/smørbødet -- the sandwitch
en sitron/sitronen/sitroner/sitronene -- the lemon
en kokk/kokken/kokker/kokkene -- the cook
kokker          -- to cook
kokte           -- cooked
et jordbær/jordbæret/jordbær/jordbærene -- the strawberry
jordbaerkaken   -- the strawberry cake
en vegetarianer/vegetarianeren -- the vegetarian
bakevarer/bakevarene -- the baked goods
en pizza/pizzaen/pizzaer/pizzaene -- the pizza
jul             -- Christmas
ribbe           -- pork belly
pinnekjøtt      -- lamb ribs
nyttårsaften    -- new years eve
julaften        -- christmas eve
julebord        -- christmas party
på forhånd      -- behorehand, in advance : På forhånd, takk! -- thanks in advance!
til og med      -- even, also
en leke/leken/leker/lekene -- the toy
ønsker/å ønske  -- to wish
å gjøre noe med -- to do something about : (with)
en maling/malingen/malinger/malingene        -- the paint
maler/å male    -- to paint : mal det -- paint that!
malt            -- painted : har malt -- have painted
en maler/maleren/malere/malerne -- painter
en eske/esken/esker/eskene -- the box
en peis/pesen/peiser/peisene -- the fireplace : peiser kan være farlige -- fireplaces can be dangerous
en møbel/møbelen/møbler/møblene -- the furniture : a piece of furniture
en kommode/kommoden/komoder/komodene -- the dresser
lås/å lås       -- to lock
låste           -- locked
et hull/hullet/hull/hullene  -- the hole
et hjørne/hjørnet/hjørner/hjørnene -- the corner
rundt           -- around, approximately : rundt hjønet -- around the corner, verden rundt --  the world around
en fryser/fryseren/frysere/frysere -- the freezer
et tak/taket/tak/takene -- the roof, ceiling
et loft/loftet/loft/loftene  -- the attic
en etasje/etasjen/etasjer/etasjene -- the floor
en duk/duken/duker/dukene -- the tablecloth
setter/å sette  -- to place : to put, jeg setter eskene på loftet -- i'm putting the boxes in the attic
legger/å legge  -- to put down, lay : du må legge : jeg legger dem her -- i'm putting them here : legg dem her -- put them here
putter/å putte  -- to put
en kjeller/kjelleren/kjellere/kjellerne -- the basement
et speil/speilet/speil/speilene -- the mirror
støv            -- the dust
en blyant/blyanten/blyanter/blyantene -- the pencil
en fjernkontroll/fjernkontrollen -- the remote control
dørmatte        -- the doormat : /dørmattene
definitiv/definitivt -- definitely : definitivt (-et)
stikker/å stikke -- run off : jeg må stikke -- i must runn off
før             -- before : dette har aldri skjedd før -- this has never happened before
en vane/vanen/vaner/vanene -- the habit
uvane           -- the bad habbit : /uvaner/uvenene
slem/slemt      -- mean, unkind : slemt (-et)
daglig/daglige  -- daily : (e-pl) : vi har daglige møter pa jobb -- we have daily meetings at work
et stoppskilt/stoppskiltet/stoppskilt/stoppskiltene -- the stop sign
sparkesykler    -- the scooters
sakte           -- slowly
saktere         -- slower
et hår/håret/hår/hårene -- the hair
lav/lavt/lave   -- low, short : lavt (-et)/lave (pl) : de er lave -- they are short
lavere          -- lower
laveste         -- lowest
et bein/beinet/bein/beina -- the leg, bone : jeg er sliten i beina -- my legs are tired
en dress/dressen/dresser/dressene -- the suit
et frak/fraket/frakker/frakkene-- the coat
en bane/banen/baner/banene -- the field
fotballbannen   -- the soccer field
en løk/løken/løker/løkene -- the onion : (easy search loken)
en sopp/soppen/sopp/soppene -- the mushroom
søndagsåpne     -- open on sunday
en hamburger/hamburgeren/hamburgere/hamburgerne -- the hamburger
rulleskøytene   -- the rollerskates : (pl)
loppemarkedet   -- the flea market : et loppemarked/loppemarkedet
en heis/heisen/heiser/heisene -- the elevator
under           -- under: underneath, below
et undertøy/undertøyet/undertøyer/undertøyene -- the underwear
et skjegg/skjegget/skjegg/skjeggene -- the beard
smykker         -- jewlery
et halskjede/halskjedet/halskjeder/halskjedene -- the necklace
blond           -- blond haired
en lomme/lommen/lommer/lommene -- the pocket
en lommebok/lommeboken/lommebøker/lommebøkene      -- the wallet
passer/å passe  -- to fit : passer skoene -- do the shoes fit?
passer på       -- to look after : å passe på
trang           -- tight, narrow : skoene er trang -- the shoes are tight
en knapp/knappen/knapper/knappene -- the button
perfekt         -- perfectly
verktøykasse    -- worktoolbox
et bilde/bildet/bilder/bildene -- the photo, picture
en båt/båten/båter/båtene -- the boat
en natur/naturen/naturer/naturene -- the nature
en innsjøe/innsjøen/innsjøer/innsjøene        -- the lake
en temperatur/temperaturen/temperaturer/temperaturene -- the temperature
en grad/graden/grader/gradene -- the degree
celsius         -- celcius
gjennom         -- through
leiebilen       -- the rental car
forlater/å forlate -- to leave : forlat nå -- leave now!
forlot          -- left
en klokke/klokken/klokker/klokkene -- the watch : clock
vekkerklokken   -- the alarm clock  : en vekkerklokke/vekkerklokken
en rutine/rutinen/rutiner/rutinene -- the routine
dusjer          -- to shower
en tann/tannen  -- the tooth
tenner/tennene  -- the teeth
syltetøyet      -- the jam
pusser          -- to clean, polish : pusser tennene -- brush the teeth
en gård/gården/gårder/gårdene -- the farm
et blad/bladet/blader/bladene -- the magazine
et selskap/selskapet/selskaper/selskapene -- the company
en fugl/fuglen/fugler/fuglene -- the bird
en elg/elgen/elger/elgene -- the moose, elk
en and/anden/ander/endene -- the duck
en hest/hesten/hester/hestene -- the horse
en bjørn/bjørnen/bjørner/bjørnene -- the bear
en edderkopp/edderkoppen/edderkopper/edderkoppene -- the spider
lukter/å lukte  -- to smell : bie ere
en mus/musen/mus/musene -- the mouse
en ulv/ulven/ulver/ulvene -- the wolf
en veterinær/veterinæren/veterinæren/veterinærene -- the veterinary : 
et bånd/båndet/bånd/båndene -- the leash, ribbon
agurktid        -- slow news season : (cucumber time)
folk            -- people
sist/siste      -- last, last : hvem kom sist -- who came last, siste gang -- last time 
mister/å miste  -- to loose, miss : jeg mister nøklene
mistet          -- lost : har mistet, jeg mistet bussen -- I missed the bus
ligger/å ligge  -- to lie : hvor ligger spania -- where is (lies/located) spain
ligget          -- lay, was lying : ke qenë, katten har ligget på sofaen -- the katt has been lying on the sofa
lå              -- lay : qe, han lå i sengen -- he was (was lying) in bed
en anelse/anelsen/anelser/anelsene -- idea : jeg har ingen anelse -- i have no idea
nede            -- downstairs : så du nede -- did you look domnstairs?
oppe            -- upstairs : rommet mitt er oppe -- my room is upstairs
en lur/luren/lurer/lurene -- the nap : jeg må ta en lur -- i have to take a nap
overalt         -- everywhere
en skuff/skuffen/skuffer/skuffene -- the drawer
en medisin/medisinen/medisiner/medisinene -- the medicine
heltid          -- full time : jeg jobber heltid -- i work fulltime
en mastergrad/mastergraden/mastergrader/mastergradene -- the masters degree
lingvistikk     -- linguistics
informatikk     -- computer science
et kurs/kurset/kurs/kursene -- the course
en forelesning/forelesningen/forelesninger/forelesningene -- the lecture
en karakter/karakteren/karakterer/karakterene -- the grade
en høyskole/høyskolen/høyskoler/høyskolene -- the university, college
et badekar/badekaret/badekar/badekarene -- the bathtub
et håndkle/håndkleet/håndklær/håndklærne -- the towel
en studentbolinge/studentbolingen/studentbolinger/studentbolingene -- the student dorm
et semester/semesteret/semestre/semesterne -- the semester
en rockekonsert/rockekonserten/rockekonserter/rockekonsertene -- the rock consert
en fyr/fyren/fyrer/fyrene -- the guy
en trom/trommen/trommer/trommene -- the drums
en musiker/musikeren/musikere/musikerne -- the musician
en scene/scenen/scener/scenene -- the stage : skena
en smarttelefone/smarttelefonen/smarttelefoner -- the smart phone
favorittseng    -- favorite song
et album/albumet/album/albumene -- the album
låner/å låne    -- to lend
gråter/å gråte  -- to cry : de grater -- they're crying
gråt            -- cried
hjemmefra       -- from home
en tvilling/tvillingen/tvillinger/tvillingene -- twins
tvillingbroren  -- the twin brother : hun har en tvillingbror
hel             -- whole : har du en hel flaske -- do you have a whole bottle?
en forfatter/forfatteren/forfatterer/forfatterne      -- the author : 
bygger/å bygge  -- to build : hva bygger vi -- what are we building?
bygde           -- built : was building
bygget          -- built : is built : dette er bygget på oss -- this is built for us
et bygg/bygget/bygg/byggene -- the building
en robot/roboten/roboter/robotene -- the robot
matte           -- math: mathematics
matematikk      -- the mathematics
en matte/matten/matter/mattene -- rug
drømmejobb      -- dream job
en ingeniør/ingeniøren/ingeniører/ingeniørene -- engineer
en pilot/piloten/piloter/pilotene -- pilot
et helikopter/helikopteret/helikoptre/helikoptrene -- the helicopter
en komiker/komikeren/komikere/komikerne -- comedian
et landskap/landskapet/landskap/landskapene -- the landscape
en fotograf/fotografen/fotografer/fotografene     -- the photographers
en premie/premien/premier/premiene -- the prize
tjener/å tjene  -- to earn : also to serve
tjente          -- earned
fortjener       -- to deserve
fortjente       -- deserved
et miljø/miljøet/miljøer/miljøene -- the environment
en filmstjerne/filmstjernen/filmstjerner/filmstjernene -- the movie star
et slips/slipset/slips/slipsene -- the tie
velger/å velge  -- to choose, select
valgte          -- chose, selected
et belte/beltet/belter/beltene -- the belt
et gull/gullet/gull/gullen -- the gold
morsdagen       -- the mothersday
et skinn/skinnet/skinn/skinnene -- the skin, the leather: the animal hide
farsdagen       -- the fathersday
velger/å velge  -- to choose
et salg/salget/salg/salgene -- sales 
til salgs       -- for sale
et prøverom/prøverommet/prøverom/prøverommene -- fitting rooms
en plakate/plakaten/plakater/plakatene -- the poster
kjemmekontoret  -- the home office
en kjøper/kjøperen/kjøpere/kjøperne -- the buyer
en shorts/shortsen/shorts/shortsen -- the shorts
lommepenger     -- pocket money
en skjerm/skjermen/skjermer/skjermene -- the screen : blåskjerm -- blue screen
bør             -- should, ought to
en nakke/nakken/nakker/nakkerne -- the neck
stiv            -- stiff
en nese/nesen/neser/nesene   -- the nose 
et øre/øret/ører/ørene -- the ear
blek/bleke      -- pale : (-e pl)
regelmessig     -- regularly
alkoholen       -- the alcohol
svinekjøtt      -- pork
storfekjøtt     -- beef
en tunge/tungen/tunger/tungene -- the tounge
en kropp/kroppen/kropper/kroppene -- the body
en helse/helsen -- the health
en munn/munnen/munner/munnene  -- the mouth
peker/å peke    -- to point : peker på -- point at
pekte           -- pointed
tærne           -- the toes : tær/tærne
et ansikt/ansiktet/ansikter/ansiktene -- the face
planer          -- plans
frekk/frekt/frekke -- rude : (-e pl), et frekt svar -- a rude answer
i det hele tatt -- at all
løser/å løse    -- to solve
biologi         -- biology
geografi        -- geography
en minne/minnen/minner/minnene -- the memory
forleden        -- the other : forleden kveld -- the other night
et kart/kartet  -- the map
innflyttingsfest-- house warming party
overfor         -- accross
spesielt        -- especially
typisk          -- typical
kvadratmeter    -- square meters
en pølse/pølsen/pølser/pølsene -- the sausage
et ektepar/ekteparet -- the married couple
et potetgulle/potetgullet -- the chips
sprøtt          -- crispy
sprø            -- crispy
sprøest         -- crispiest
en slange/slangen -- the snake
slangeskinn     -- snakeskin
en dagbok/dagboken  -- the diary
løser/å løse    -- to solve
løste           -- solved
puslespill      -- puzzles
en kunst/kunsten -- art
et fag/faget/fag/fagene -- the subject : school subject
innflyttingsfesten -- the housewarming party
en ektefelle/ektefellen -- the spouse
komfyren        -- the stove
katedralen      -- the cathedral
vinmonopolet    -- the wine monopoly
utsikten        -- the view
uvanlige        -- unusual
opp til meg     -- up to me
sender/å sende  -- to send : send meg -- send me
sendte          -- sent
mater/å mate    -- to feed
et postkort/postkortet -- the postcard
tjeneste        -- favor
et dekk/dekket/dekkene -- the tire
flat/flatt      -- flat : et flatt dekk -- a flat tire
skifter/å skifte -- to change : to shift
skiftet         -- changed
en mekaniker/mekanikeren/mekanikerne -- the mechanic
et brev/brevet/brev/brevene -- the letter
et konvolutt/konvolutten -- the envelope
en frimerke/frimerken/frimerker -- the stamp
skyld           -- sake : for jentas skyld -- for the girls sake
en boks/boksen/bokser/boksene -- the can
ølboksen        -- the beer can
takker          -- to thank
takket          -- thanked
sender ut       -- send out
setebelter      -- seatbelts
en sektretær/sekretæren -- the secretary
kopiere         -- to copy
dokumenter      -- documents
en konferanse/konferansen/konferanser/konferansene -- conference
reparerer/å reparere -- to repair
en maskin/maskinen -- the machine
en prest/presten/prester -- the priest
håndverker      -- tranesperson
fritiden        -- the free time : en fritid/fritiden
sjelden         -- seldom, rarely
bussjåføren     -- the bus driver
trikkesjåføren  -- the tram driver
sommerjobb      -- summer job
telefonselger   -- telemarketer
brannmennene    -- the firemen
en rørlegger/rørleggeren/rørleggere /rørleggerne -- the plumber : (lit tube doctor)
en elektriker/elektrikeren/elektrikere/elektrikerne -- the electrician
overtid         -- overtime
arbeidsklærne   -- workclothes
arbeidsmiløet   -- the working environment
india           -- india
gresk/greske    -- greek : (-e pl)
en forrett/forretten -- the appetizer
en hovedrette/hovedretten-- the main course
leveringstjenesten -- the delivery service
tilbyr/å tilby  -- to offer
tilbød          -- offered
en tallerken/tallerkenen/tallerkener/tallerkenene -- the plate
en bønne/bønnen/bønner/bønnene -- the bean
kaffebønner     -- coffee beans
et måltid/måltiden -- the meal
serverer        -- to serve
sur             -- sour
en laks/laksen/laks/laksene -- the salmon
husnummeret     -- the house number
postnummeret    -- the zip code
smør            -- butter
hvitløk         -- garlik
rødløk          -- red onion
oljen           -- the oil : en olje/oljen
et tips/tips    -- the tip : a tip
småpenger       -- change
eddik           -- vinegar
riseddik        -- rice vinegar
en rykte/rykten/rykter/ryktene -- the rumor
sladrer/å sladre-- to gossip
lyver/å lyve    -- to lie, lying
løy             -- lied : hun løy for meg -- she lied to me
spøkelset       -- ghost : et spokelse/spokelset/spokelser/spokelsene
hjemsøkt        -- haunted
ond/onde        -- evil
nysgjerrig      -- curious : jeg er nysgjerrig
en heks/heksen/hekser/heksene -- witch
et uhyre/uhyret/uhyrer/uhyrene -- the monster
føler/å føle    -- to feel
følt            -- felt
en følelse/følelsen/følelser/følelsene -- feeling
en fjord/fjorden/fjorder/fjordene -- fjord
en forrett/forretten/forreter/forrettene -- the appetizer
hjemsøkte       -- haunted
studentbyen     -- student village
kleshengere/kleshengerne -- clothes hangers
oppholder/å oppholde -- to reside, occupy : oppholder oss
campusen        -- the campus
internasjonale  -- international
et laken/lakenet/laken/lakene -- the sheet
ved siden av    -- next to
en vifte/viften/vifter/viftene -- the fan
en vegg/veggen/vegger/veggene -- the wall
en søppelbøtte/søppelbøtten/søppelbøtter/søppelbøttene -- the trash can : søppelbøtta
en gardin/gardinen/gardiner/gardinene -- the curtain
en lader/laderen/ladere/laderne -- the charger
vannkoker       -- water boiler
ler/å le        -- to laugh
lo              -- laughed
forelsket       -- in love : jeg er forelsket -- i'm in love
himmelen/en himmel -- the heaven : åpen himmel -- open sky
mennesker       -- people
ensomt/ensomme  -- lonely : (-me pl)
deprimert       -- depressed
et hjerte/hjertet -- the heart
bitter/bitre    -- bitter : (-re pl)
stolt/stolte    -- proud : (-e pl)
normal          -- normal
klager/å klage  -- to complain
akkurat         -- exactly
pianoet/et piano -- the piano
broen/en bro    -- the bridge
skjellet/et skjell -- the shell
en vei/veien    -- the way : hvor er jeg på vei -- where am i headed?
kø              -- the queue
bakken/en bakke/bakker/bakkene -- the hill: bakene er store -- the hills are big
vinker          -- to wave
bikinien/en bikini -- the bikini
hoved           -- main : hovedgaten-- main street, hovedskilde -- main source
staden          -- a city
hovedstaden     -- the capital city
krysser/å krysse -- to cross :
ikke kryss!     -- don't cross
krysset         -- crossed
kultur          -- the culture
damen/en dame/damer/damene -- the lady
herren/en herr/herrer/herrene -- the gentleman
lander/å lande  -- to land
timeglasset/et timeglass -- the hourglass
normalt         -- normal
betydelig       -- significant : (meaninful)
anser           -- to consider
sjenerøs        -- generous
rimelig         -- reasonable, fair
andel           -- the share : andel av markedet -- share of the market
trusselen/en trussel -- the threat : trusselbrev -- threat letter
iskald          -- freezing
strikker/å strikke -- to knit
videoen/en video/videoer/videoene -- the video
skjerfet/et skjerf/skjerfer/skjerfene -- the scarf
omelett/omeletter -- the omelet
telefonselgeren -- telemarketer
tekstmeldingen/en tekstmelding/tekstmeldinger/tekstmeldingene  -- the text message
spaet/et spa    -- spa
kjorer snowboard -- to snowboard: drive a snowboard
iskaldt         -- freezing: ice cold
et alfabet/alfabetet -- the alphabet
bokstaver/bokstavene -- the letter: shkronja
staver/å stav   -- to spell : me shkrue, me shkronjoj
en hanske/hansken/hansker/kanskene -- the glove
toast           -- toast
ski/skiene      -- the skis
går på ski      -- go skiing
snømann         -- the snowman
skøyter         -- skate : går på skøyter -- to skate, to go on skates
vinterstøvler/vinterstøvlene -- the winterboots
en elev/eleven/elever  -- the student
studentkort     -- student card
skoleuniform    -- school uniform
en setninger/setningeren/setninger/setnivgene -- statement, sentence :
et klasserom/klasserommet -- the classroom
skjønner/å skjønne -- to see, to understand : jeg skjønner -- I understand
unntatt         -- except, but
en tavle/tavlen/tavler -- the board : blackboard, tavla


##

utvekslingsstutent -- exchange student
vanvittig       -- insanely
tross           -- despite (til tross -- despite)
bryst           -- chest (ditt bryst -- your chest)
forberedelser   -- preparations
likesom         -- like
eksempel        -- example, for eksempel -- such as
derfor          -- therefore
utlending       -- foreigner
bryr            -- care : jeg bryr ikke -- I dont care
imot            -- against : jeg har ingenting imot det -- i have nothing against it, jeg har ikke noe imot det -- i don't mind
oversettelsen   -- perkthimi, translation
samtale         -- conversation : samtale/samtalene
tilgjengelig    -- available : denne bok er nå tilgjengelig -- this book is now available
helvete         -- hell
herregud        -- oh my god
svartedauden    -- the black death (plague)
befolkningen    -- population
herjer          -- reign
lovløshet       -- lawlessness
øde             -- desolate
kar             -- fellow
avhenger        -- depends
anbefales       -- reccomended
kjappa          -- quick : kjappa på --
kjapt           -- quickly
mener           -- to mean : å mene
påfyller        -- to refill
påfyllet        -- refill : et påfyll/påfyllet
annet           -- other : noe annet sted -- anywhere else, kan vi dra et annet sted -- can we go somewhere else
tall            -- number, shifér
jævlig          -- damn
oppgaven        -- task : en oppgave/oppgaven
masteroppgaven  -- the master thesis
statsminister   -- prime minister
forholdet       -- relationship : et forholde/forholdet/
tausheten       -- the silence : en taushete/tausheten
legge           -- to lay
saken           -- the case, matter : en sake/saken
overraska       -- surprised
utstrakt        -- extensive
loven           -- the law : en lov/loven/lover/lovene
lover           -- to vow: promise : å love
fusk            -- cheating
juks            -- cheating
mistenkt        -- suspected
opplever        -- to experience : får opleve -- to enjoy the experience
utestengt selv  -- be banned
utdanning       -- education : hoyere utdanning -- higher education
hovn            -- revenge
klarer          -- to manage : to handle, to clear : å klare : jeg klarer ikke -- i can't do it
forestiller     -- to represent : å forestille
forestiller deg -- to imagine
drøm            -- to dream
drømt           -- dreamt
vel             -- well : (in veldig) : ja vel -- oh well
øst             -- east
vest            -- west
nord            -- north : nordøst -- northeast
sør             -- south
nyter           -- enjoy
selvom/selv om  -- even though, although
høljer          -- heels (?), høljer ned -- pile down (accumulate)
dør             -- to die : å dø : til vi dør -- until we die
slår            -- to turn back: kthehu : å slå -- to turn , slår av -- turn off : å slå av lyset -- to turn off the light
slår            -- to beat: rreh
foreslår        -- to propose
slår av         -- turn off
slår opp/slå opp -- look up : slå det opp -- look it up
troen           -- the faith : en tro/troen (also troa)
tviler          -- to doubt : å tvile
tvilte          -- doubted
stoler          -- to trust : å stole
sårer           -- to hurt, wound : å såre
såra            -- hurt, wounded
hemmlighet      -- secret
hemmelig        -- secret
følger/å følge  -- to follow : følg! (easy search folger)
sjok            -- shock
sjokkert        -- shocked
stemmer         -- votes : det stemmer -- that's right, stemmer det? -- is that true?
patruljen       -- patrol, police : en patrulje/patruljen
usannsynlig     -- unlikely
bortført        -- abducted
hørbar          -- audible
uhørbar         -- inaudible
dialog          -- dialog
krever          -- to request
utlevert        -- released, out delivered
levere          -- to deliver : å levere
levert          -- delivered
fnyser          -- to snort, gërrhij
undersøker      -- to investigate
friheten        -- the freedom : en frihet/friheten
velger          -- to choose
foran           -- before, over: velger foran penger -- freedom over money
ansvaret        -- responsability
risiko          -- risk
reelt           -- real
beskytte        -- to protect
beskytter       -- guardian
våkner          -- to wake up
våknet          -- woke
målene          -- goals
nå              -- to reach : å nå
poteter         -- potatoes
gulrøtter       -- carrots
kaninen         -- the rabbit : en kanin/kaninen/kaniner/
skuffet         -- dissapointed
plutselig       -- suddenly
lappen          -- the note : en lapp/lappen
søker           -- to seek : å søke
ensom           -- lonely
papegøyen       -- the parrot : en papegøy/papegøyen/
vennskap        -- friendship
invitert        -- invited : har invitert -- had invited
inviterte       -- invited : did invite
trykker         -- to press
ringeklokka     -- doorbell
klapper         -- to caress : å klappe
smiler          -- to smile
lue             -- the hat, kapuç
votter          -- the mittens, gloves
gresset         -- the grass: et gress/gresset
kiler           -- to tickle : å kile
ull             -- wool : ullbukse -- wool trousers, ullgenser -- wool sweater
huden           -- the skin : en hud/huden
heldig          -- fortunate
nydelig         -- beautiful
fornøyesen      -- the pleasure : en fornøyese/fornøyesen
lidenskapen     -- the passion : en lidenskap/lidenskapen
trolig          -- belieaveable
utrolig         -- unbeliaveable
komplisert      -- complicated
ukomplisert     -- uncomplicated
vet siden       -- next to
havet           -- the sea : et hav/havet
sjøen           -- the sea : en sjø/sjøen
sjømenn         -- sailors
en fordele/fordelen/fordeler/fordelene -- the advantage
omringet        -- surrounded
passerer        -- to pass
studien         -- the study: en studi/studien/studier/studiene
opptatt         -- busy : jeg er opptat med studiene -- im busy with the studies
stod            -- passed (the classes)
attpåtil        -- furthermore
merkelig        -- strange
slappe av       -- to relax : to chill
stå på ski      -- to go skiing
henger          -- to hang: å henge : å henge opp klær -- hang clothes
hengt           -- hung : har hengt
dekker          -- to prepare : å dekke : å dekke bordet -- to prepare the table
suger           -- to suck : å suge
støvsuger       -- to vacuum : to dustsuck
oppvasken       -- dishes : å ta oppvasken -- to wash the dirty dishes
tørker          -- remove : å tørke : å tørke støv -- to remove dust
kniv            -- knife
preposisjonen   -- preposition : preposisjoner/preposisjonene
sommerfesten    -- the summer fest
mysteriøse      -- mysterious
midten          -- middle : i midten -- in the middle
tvang           -- coerced : tvang meg -- made me
forskning       -- research
fortelle        -- tell: reveal
fortalte        -- told: fortalt
kalt            -- called : var kalt -- was called
klar            -- clear
klart           -- clearly : så klart -- of course
nettsider       -- websites
steder          -- places
informasjon     -- information
glipp           -- miss : gå glipp av det -- go and miss it
spektakulær     -- spectacular
ligner          -- to resemble : to look like
lignet          -- resembled : looked like
slik            -- such
klarte          -- was able to do
forklarer       -- to explain : å forklare
forklarte       -- explained : did explain
forklart        -- explained : har forklart
handlet om      -- was about
rotet           -- the mess : et rot/rotet : for et rot -- what a mess!
tidspunktet     -- the moment : point in time : et ditspunkt/tidspunktet
skyndte         -- hurried
hundrevis       -- hundreds
tusenvis        -- thousands
rad             -- row : tredje på rad -- third in a row
stunden         -- the moment
en stund        -- for a while
aksenten        -- the accent : en aksent/aksenten
synd            -- pitty : så synd -- such a pitty!
unngå           -- avoid : å unngå
heten           -- the heat : en het/heten
berømte         -- famous
svømmebriller   -- swimming goggles
vanntette       -- waterproof
sjanse          -- chance : siste sjanse -- last chance
tåler/å tåle    -- to withstand
puster          -- to breathe
gravid          -- pregnant
brud            -- bride
stallkar        -- groom
spørreskjema    -- questionnaire
oppdager        -- to discover
oppdaget        -- discovered
eget            -- own
fengsel         -- prison
saken           -- the case
henlagt         -- was closed
turgåer         -- hikers
omkom           -- perished, died
ulykke          -- accident
sti             -- path
køyrer          -- to drive
feil            -- wrong
innstilling     -- settig
eldes           -- to age
romkappløp      -- space race
løpet           -- race : et løp/løpet
i løpet av      -- in the course of : during
høststorm       -- autumn storm
rammer          -- frame
sprenger        -- to explode : blow up : sprenger ut -- break out
krappe          -- tight
svinger         -- swings : turns
will            -- wild : wild guess - vill gjetning
vilt            -- wild : wild animal - vilt dyr
urovekkande     -- disturbing
tal             -- numbers
skulking        -- truancy : absence from school
gal             -- crazy
gissel          -- hostage
livsfarlig      -- deadly
kunstig intelligens -- artificial intelligence
reguleres       -- be regulated
avtale          -- the agreement, deal, appointment
seir            -- victory
en seier/seieren -- victory
lår             -- thigh
skam            -- shame
bøyd            -- past, bent
skyer           -- clouds
kjipe           -- crappy
geiten          -- the goat : en geit/geiten
grøt            -- porrige
ustabilt        -- unstable
avstand         -- distant
koselig         -- nice
koser           -- to enjoy : koser seg -- have fun
annen           -- another, different
samfunnet       -- the society
hertug          -- duke : title of duke
antar           -- to guess, assume
forhandle       -- to negotiate : forhandle på nytt -- renegotiate
utfordrende     -- challenging
aner            -- to sense
aldeles ikke    -- absolutely not
ta innover      -- to take in : to understand
en skyss        -- a ride : skyss hjem -- a ride home
spaserer        -- to walk : jeg spaserer -- i'm walking
nåde            -- grace : deres nåde -- your grace
flink           -- proficient, clever : jeg er ikke flink -- i'm not good with
sak             -- business : det er ikke min sak -- it's not my business
en rev/reven    -- the fox
lurer/å lure    -- to wonder, deceive : å lure på -- to wonder
lurte           -- wondered, deceived : did wonder
lurt            -- deceived : bli lurt -- e deceived : har lurt -- have deceived
kjeft           -- shut up
knipen/en knipe -- the predicament
forretning      -- business
roten/en rot/røtter/røttene -- the root
slått           -- struck : har slått røtter -- have taken roots
en rekke grunner -- a number of reasons
en jævel/jævelen/jævler/jævlene -- the bastard
med farta       -- with speed



